                                                                                                          
                                    ░░▓▓░░░░░░░░░░░░░░░░▓▓░░                                              
                                  ▒▒░░░░░░░░░░░░▒▒▒▒░░░░░░░░██      ██████                                
                                ▒▒▓▓░░░░░░░░░░░░▒▒▒▒▒▒▒▒▒▒▒▒░░▒▒░░▒▒░░░░░░░░▓▓▒▒                          
                      ░░██▒▒██░░██▒▒▒▒▒▒░░░░░░▒▒▒▒▒▒▒▒▓▓▓▓▓▓▒▒░░░░░░▒▒▒▒░░░░░░░░▓▓▒▒                      
                  ██▓▓▒▒▒▒░░░░▒▒▓▓▓▓▓▓▒▒▒▒▒▒▒▒░░▒▒░░▒▒▓▓▓▓▓▓▓▓▒▒░░▒▒▒▒▒▒▒▒▒▒▒▒░░░░░░██                    
                ██░░░░▒▒▒▒▓▓▓▓▒▒▒▒▒▒▓▓▒▒▒▒▒▒▒▒▒▒░░▒▒▓▓▓▓▓▓▓▓▒▒▒▒▒▒▒▒▒▒▓▓▒▒▒▒▒▒░░░░░░▒▒▒▒                  
              ░░▓▓▒▒▒▒▓▓▓▓▓▓▓▓██▓▓▒▒▒▒▓▓▓▓▓▓▒▒▒▒▒▒▒▒▓▓▓▓▓▓▓▓▒▒░░▒▒▓▓▓▓▓▓▓▓▒▒▓▓▒▒▒▒▒▒▒▒██▒▒▒▒░░            
              ▒▒▓▓▓▓▓▓▓▓░░░░░░░░░░░░░░▓▓▓▓▓▓▓▓▒▒▒▒▒▒▓▓▓▓▓▓▓▓▓▓▓▓▓▓▓▓▓▓▓▓▓▓████▓▓▓▓▓▓▓▓▒▒░░░░▒▒▒▒          
          ▒▒▓▓██▓▓▓▓░░░░░░▒▒▒▒▓▓▓▓▓▓▓▓▓▓▓▓▓▓▓▓▓▓▓▓▓▓▓▓████▓▓▓▓▓▓▓▓▓▓▓▓░░░░░░░░░░██▓▓▓▓▓▓▓▓▒▒░░▒▒          
      ░░██▓▓▒▒░░▓▓▓▓░░░░▒▒▓▓▓▓▓▓██▓▓▒▒░░░░▒▒▓▓▓▓▓▓▓▓▒▒░░░░░░░░░░▒▒▓▓▓▓▒▒▓▓▓▓▒▒▒▒▒▒▓▓▓▓▓▓▓▓▒▒▒▒▓▓▓▓░░░░    
    ░░██▓▓▓▓░░░░▒▒▒▒▒▒▒▒▓▓▓▓▓▓██▒▒░░░░░░░░░░░░░░▓▓▒▒░░░░░░░░░░░░░░▒▒▒▒▒▒▓▓▒▒▓▓▒▒▓▓▒▒▒▒██▓▓▓▓▒▒░░░░░░██░░  
    ██▓▓▓▓▒▒░░▒▒▓▓▓▓▓▓▓▓▓▓▓▓▓▓▓▓▒▒░░░░▒▒▒▒░░░░░░░░░░░░▒▒▒▒▒▒▒▒▒▒░░░░░░▒▒░░░░▓▓▓▓▓▓▓▓▒▒██▒▒░░░░░░▒▒▒▒░░▒▒  
    ██▓▓▓▓▓▓▓▓▓▓▓▓▓▓▓▓▓▓▓▓██▓▓▒▒▒▒░░░░▒▒▒▒▒▒░░░░░░▒▒▒▒▒▒▒▒▓▓▒▒▒▒▒▒░░░░▒▒▒▒░░░░▓▓▓▓▓▓▓▓▓▓▓▓▒▒▒▒▒▒▓▓▓▓▒▒░░▒▒
    ░░██████▓▓▒▒██▓▓▓▓▓▓▓▓██▒▒▒▒▒▒▒▒▒▒▒▒▒▒▒▒▒▒░░▒▒▓▓▒▒▒▒▒▒▓▓▒▒▒▒▒▒▒▒▒▒▒▒▒▒░░░░░░▓▓▓▓▓▓▓▓▓▓▓▓▓▓▓▓▓▓▓▓▓▓░░▒▒
    ██▓▓▓▓▒▒▒▒██▓▓▒▒▒▒░░██▓▓▓▓▒▒▒▒▒▒▒▒▓▓▓▓▒▒▒▒░░▒▒▒▒▓▓▓▓▓▓▓▓▓▓▒▒▒▒▓▓▓▓▒▒▒▒░░▒▒▒▒░░▒▒▓▓▓▓▓▓▒▒░░░░▒▒▓▓▓▓▒▒▓▓
  ▓▓▓▓▓▓▒▒░░░░▓▓▒▒▒▒░░░░▓▓▓▓▓▓▓▓▒▒▒▒▓▓▓▓▓▓▒▒▒▒▒▒▒▒▒▒▓▓▓▓▓▓▓▓▓▓▓▓▓▓▓▓▒▒░░▒▒▒▒▒▒▒▒▒▒▒▒▓▓▓▓░░░░░░░░░░░░██▓▓▓▓
  ▓▓▓▓▒▒░░░░▓▓▓▓▒▒▒▒░░░░░░▓▓▓▓▓▓▓▓▓▓▓▓▓▓▓▓▒▒▒▒▒▒▒▒▒▒▒▒▓▓▓▓▓▓▓▓▓▓▓▓▓▓▒▒░░░░░░▒▒▒▒▓▓▓▓▓▓▒▒▒▒▒▒▓▓▒▒░░░░██▓▓▓▓
  ▓▓▓▓▒▒░░▒▒▓▓▓▓▒▒▒▒▒▒▒▒░░▒▒▓▓▓▓▓▓▓▓▓▓▓▓▓▓▓▓▒▒▒▒▓▓▓▓▓▓▓▓▓▓▓▓▓▓▓▓▓▓▓▓▓▓▒▒▒▒▒▒▒▒▓▓▓▓▓▓▓▓▓▓▓▓▓▓▒▒▒▒▒▒░░██▓▓██
  ▓▓▓▓▒▒▒▒▒▒██▓▓▒▒▒▒▒▒▓▓▒▒▒▒░░▒▒▓▓▓▓▓▓▓▓▓▓▓▓▓▓▓▓▓▓▓▓▓▓▓▓▓▓▓▓▓▓▓▓▓▓▓▓▓▓▓▓▓▓▓▓▓▓▓▓██▓▓▓▓▓▓▓▓▓▓▓▓▒▒▒▒▒▒██▓▓▒▒
  ▓▓▓▓▓▓▒▒▒▒▓▓▓▓▓▓▓▓▓▓▓▓▓▓▒▒▒▒▓▓▓▓▓▓▓▓▒▒░░▒▒▓▓▓▓▓▓▓▓▓▓▓▓▓▓▓▓▓▓▓▓▒▒▓▓▓▓▓▓▓▓▓▓██▓▓▓▓▓▓▓▓▓▓████▓▓▒▒▓▓▒▒██▒▒  
  ▓▓▓▓▓▓▒▒▒▒▓▓▓▓▓▓▓▓▓▓▓▓▓▓▓▓▒▒▒▒▓▓░░▒▒░░░░░░▓▓▒▒░░░░▒▒██████░░░░▒▒▓▓▓▓▓▓▓▓▓▓██▓▓▓▓▓▓▓▓▓▓▓▓▓▓▓▓▓▓▓▓██      
  ██▓▓▓▓▓▓▒▒▒▒▓▓▓▓▓▓▓▓▓▓▓▓██▓▓▓▓▓▓▓▓▒▒░░░░░░▓▓▒▒▒▒░░░░░░░░░░░░░░▒▒▓▓▓▓▓▓▓▓██▓▓▓▓▓▓▓▓██▓▓▓▓▓▓▓▓▓▓████      
    ██▓▓▓▓▓▓▒▒▒▒████▓▓▓▓▓▓████▓▓▓▓▒▒▒▒░░░░▓▓▓▓▓▓▒▒▒▒▒▒░░░░░░░░▒▒▓▓▓▓▓▓▓▓▓▓▓▓██████▓▓▓▓▓▓▓▓▓▓██▓▓▒▒▓▓      
    ░░▓▓▓▓▓▓▓▓▓▓▒▒▓▓██▓▓▓▓▓▓██▓▓▓▓▒▒▒▒▒▒▓▓▓▓▓▓▓▓▓▓▒▒▒▒▒▒▒▒▒▒▒▒▓▓▓▓██████████▓▓▓▓▓▓▓▓▓▓▓▓▓▓██▒▒▒▒▒▒██      
        ▒▒██▓▓▓▓▒▒▒▒▓▓▓▓▓▓▓▓▓▓▓▓██▓▓▓▓▓▓▓▓██▓▓▓▓▓▓▓▓▒▒▒▒▓▓▓▓▓▓▓▓▓▓██████▓▓██▓▓▓▓▓▓▓▓▓▓▓▓██▓▓▓▓░░▓▓░░      
          ▒▒██▓▓▓▓▓▓▓▓▓▓▓▓▓▓▓▓▓▓██▓▓▓▓██████▓▓▓▓▓▓▓▓▓▓▓▓▓▓▓▓▓▓▓▓████████▓▓██████▓▓▓▓████▓▓▓▓▓▓▓▓▓▓        
            ░░██▓▓▓▓▓▓▓▓▓▓▓▓▓▓██▓▓▓▓▓▓██▓▓████▓▓▓▓▓▓▓▓▓▓▓▓▓▓██████████▒▒▓▓▓▓██████▓▓▓▓██▓▓████▓▓          
              ░░▒▒▒▒████▓▓▓▓▓▓▓▓██████▓▓▒▒▓▓████████████████▓▓██▓▓██▓▓▓▓▓▓████▓▓▓▓▓▓▓▓██▒▒▒▒▒▒            
                    ░░▒▒██▓▓▓▓▓▓▓▓▓▓▓▓██▓▓▓▓▓▓██████▓▓██▓▓▓▓████▒▒▒▒▓▓▓▓▓▓██████▓▓▓▓██▒▒                  
                    ░░░░  ██████▓▓▓▓▓▓██▓▓▓▓██▓▓████▒▒██▓▓██▓▓▒▒▓▓▓▓▓▓████████▒▒▒▒▒▒                      
                            ▒▒▓▓▓▓▓▓██▓▓▓▓▒▒▓▓██████▒▒▓▓▓▓██▓▓▓▓▓▓▓▓████▓▓                                
                                        ▓▓▓▓▓▓██▓▓▓▓▒▒▓▓▓▓██▓▓▓▓▓▓▓▓▓▓██░░                                
                                        ██▒▒▒▒▓▓████▓▓▒▒▓▓▓▓▓▓▓▓██▓▓▓▓██                                  
                                        ▓▓▓▓▓▓▓▓████▓▓▒▒▓▓▓▓██▓▓████▓▓██                                  
                                        ▓▓▓▓▓▓▓▓████▒▒▓▓▓▓▓▓████▓▓██▒▒██▒▒                                
                                        ▓▓▓▓██▓▓██▓▓▒▒▓▓▓▓▓▓██▓▓▓▓██▓▓▓▓▓▓                                
                                        ▓▓██▓▓▓▓██▒▒▓▓▓▓▒▒▓▓██▓▓▓▓▓▓▒▒▓▓▓▓                                
                                        ▓▓██▓▓▓▓▓▓▒▒▓▓▓▓▒▒▓▓████▓▓▓▓▓▓▓▓▓▓                                
                                        ▓▓▓▓▓▓▓▓▓▓▓▓▓▓▓▓▒▒▓▓████▓▓▓▓▓▓▓▓▓▓                                
                                        ██▓▓▒▒██▓▓▓▓▓▓▓▓▒▒▓▓████▓▓▓▓██▓▓▓▓▓▓                              
                                        ██▒▒▓▓▓▓████▓▓▓▓▒▒▓▓▓▓██▒▒▓▓▓▓██▓▓██                              
                                        ▒▒▓▓▓▓▓▓██▓▓▓▓▓▓▒▒▓▓▓▓▓▓▒▒▓▓▓▓▓▓▓▓██                              
                                      ▓▓▒▒▓▓▓▓▓▓██▓▓▓▓▓▓▒▒▓▓██▓▓▒▒▓▓▓▓▓▓████                              
                                      ██▒▒▓▓▓▓▓▓██▓▓▓▓▓▓▓▓▓▓██▓▓▓▓▓▓▓▓▓▓████                              
                                      ██▒▒▓▓▓▓▓▓██▓▓▓▓▓▓▓▓▓▓████▓▓▓▓▓▓▓▓████                              
                                    ░░▓▓▓▓▓▓▓▓████▓▓▓▓▓▓██▓▓▓▓██████▓▓▓▓████                              
                                    ██▒▒▓▓▓▓▓▓██▓▓▒▒▓▓▓▓██▓▓▓▓▓▓▓▓▓▓██▓▓████                              
                                  ░░██▓▓▓▓▓▓██▓▓▒▒▓▓▓▓████▓▓▓▓▓▓▓▓▒▒▓▓▓▓▓▓██                              
                                ▒▒████▓▓████▓▓▒▒▓▓▓▓████▓▓▓▓▓▓▓▓▓▓▓▓▓▓██▓▓▓▓▒▒▒▒▒▒░░                      
                              ▒▒██▓▓▓▓▓▓██████▒▒▓▓▓▓████▓▓▓▓▒▒▓▓▓▓▓▓▒▒██▓▓▓▓▒▒▒▒▒▒██                      
                            ▒▒██▒▒▓▓▓▓▓▓██████▒▒▓▓▓▓████▓▓████▓▓▓▓▓▓▓▓██▓▓▓▓▓▓▓▓▓▓▒▒▒▒                    
                          ░░██▒▒▒▒▓▓▓▓▓▓██████▓▓▓▓▓▓████▓▓▓▓▒▒▓▓▓▓▓▓▓▓██▓▓▓▓▓▓▓▓▓▓▒▒▒▒                    
                          ██▓▓▓▓▓▓██████████▒▒▓▓▓▓▓▓██▓▓▒▒▒▒▒▒▓▓██▓▓▓▓██████▓▓██▓▓▓▓▓▓                    
                    ▒▒▒▒████▓▓▓▓▓▓████▓▓██▒▒▓▓▓▓██▓▓██▓▓██▓▓▒▒▓▓██▓▓▓▓████████████▓▓▓▓▓▓                  
                  ████▓▓▓▓▓▓██▓▓▓▓██▓▓▒▒██▓▓▓▓▓▓████████▓▓▓▓██▓▓██▓▓▓▓▒▒▒▒▓▓██████▓▓▓▓▓▓                  
                  ██▓▓▓▓▓▓████▓▓████▓▓▓▓▓▓██▓▓▓▓▓▓██████▒▒▓▓██████▓▓████▓▓▓▓▒▒████▓▓▒▒████                
                  ██▓▓████████████▓▓▓▓▓▓▓▓██▓▓▓▓██████▓▓▓▓▓▓████████▓▓▓▓▓▓▒▒▒▒██████▓▓▓▓▓▓▓▓▓▓░░          
              ▒▒██▓▓████▓▓    ██▒▒▒▒▓▓██████████████████▓▓██████████▓▓▓▓▓▓▒▒▓▓██████▓▓▓▓▓▓██▓▓▓▓██░░      
              ▓▓▓▓████▓▓    ▒▒▓▓▒▒▓▓▓▓████▒▒░░░░  ▒▒██▓▓▓▓▓▓▓▓▓▓▓▓██████▓▓▓▓▓▓████████████████▓▓▓▓▓▓      
              ██████░░      ████▓▓▓▓██▒▒░░        ▒▒████▓▓▓▓▓▓▓▓▒▒▓▓████████████▓▓██▓▓▓▓  ░░  ▒▒████      
              ▓▓            ▒▒▓▓██████░░            ▓▓▓▓▓▓██▓▓██████████▓▓████▓▓██████▓▓                  
                            ████████▒▒                          ██████▒▒      ░░░░░░░░░░                  

